%%%%%%%%%%%%%%%%%%%%%%%%%%%%%%%%%%%%%
%---------%%%%%%%%%%%%%-------------%
%---------%%%%%%%%%%%%%-------------%
%---------%%%%%%%%%%%%%-------------%
%---------%%%%%%%%%%%%%-------------%
%-----------------------------------%
%---------%%%%%%%%%%%%%-------------%
%---------%%%%%%%%%%%%%-------------%
%-----------------------------------%
%---------%%%%%%%%%%%%%-------------%
%---------%%%%%%%%%%%%%-------------%
%---------%%%%%%%%%%%%%-------------%
%-----------------------------------%
%-----------------------------------%
%---------%%%%%%%%%%%%%-------------%
%---------%%%%%%%%%%%%%-------------%
%---------%%%%%%%%%%%%%-------------%
%---------%%%%%%%%%%%%%-------------%
%---------%%%%%%%%%%%%%-------------%
%%%%%%%%%%%%%%%%%%%%%%%%%%%%%%%%%%%%%
