%%%%%%%%%%%%%%%%%%%%%%%%%%%%%%%%%%%%%
%---------%-------------------------%
%---------%-------------------------%
%---------%-------------------------%
%---------%-------------------------%
%---------%-------------------------%
%---------%-------------------------%
%------------------%----------------%
%------------------%----------------%
%------------------%----------------%
%------------------%----------------%
%------------------%----------------%
%------------------%----------------%
%---------------------------%-------%
%---------------------------%-------%
%---------------------------%-------%
%---------------------------%-------%
%---------------------------%-------%
%---------------------------%-------%
%%%%%%%%%%%%%%%%%%%%%%%%%%%%%%%%%%%%%
