%%%%%%%%%%%%%%%%%%%%%%%%%%%%%%%%%%%%%
%%----------------------%-----------%
%-%---------------------%-----------%
%--%--------------------%-----------%
%---%-------------------------------%
%----%------------------------------%
%-----%-----------------%-----------%
%------%---------------%-%----------%
%-------%-------------%---%---------%
%--------%-----------%----%---------%
%---------%---------%-----%---------%
%----------%-------%-----%----------%
%-----------%-----%-----%-----------%
%------------%---%-----%------------%
%----%--------%-%-----%-------------%
%----%---------%-----%--------------%
%----%--------------%---------------%
%------------------%----------------%
%-----------------------------------%
%%%%%%%%%%%%%%%%%%%%%%%%%%%%%%%%%%%%%
