%%%%%%%%%%%%%%%%%%%%%%%%%%%%%%%%%%%%%
%-----%-----------%-----------%-----%
%-----%-----------%-----------%-----%
%-----%-----------%-----------%-----%
%-----%-----%-----%-----%-----%-----%
%-----%-----%-----%-----%-----%-----%
%-----%-----%-----%-----%-----%-----%
%-----%-----%-----%-----%-----%-----%
%-----%-----%-----%-----%-----%-----%
%-----%-----%-----%-----%-----%-----%
%-----%-----%-----%-----%-----%-----%
%-----%-----%-----%-----%-----%-----%
%-----%-----%-----%-----%-----%-----%
%-----%-----%-----%-----%-----%-----%
%-----%-----%-----%-----%-----%-----%
%-----%-----%-----%-----%-----%-----%
%-----------%-----------%-----------%
%-----------%-----------%-----------%
%-----------%-----------%-----------%
%%%%%%%%%%%%%%%%%%%%%%%%%%%%%%%%%%%%%
