%%%%%%%%%%%%%%%%%%%%%%%%%%%%%%%%%%%%%
%-----------------------------------%
%-----------------------------------%
%-----------------------------------%
%-----%%%%----------------%%%%%%%%%%%
%-----%-------------------%---------%
%-----%-------------------%---------%
%-----%-------------------%---------%
%-----%%%%%%%%%-----------%%%%------%
%-------------%--------------%%-----%
%-------------%---------------%%%---%
%------%------%---------------------%
%------%%-----%---------------------%
%------%%%--------------------------%
%-------%%%-------------------------%
%--------%%----------------%--------%
%---------%----------------%--------%
%--------------------------%--------%
%--------------------------%--------%
%%%%%%%%%%%%%%%%%%%%%%%%%%%%%%%%%%%%%
