%%%%%%%%%%%%%%%%%%%%%%%%%%%%%%%%%%%%%
%--%---%-------------------%--------%
%--%---%----%%%%%%%%%---%%%%--------%
%--%---%%%%%%-------%---%-----------%
%--%---%----%-------%---%----%------%
%------%----%-------%---%----%------%
%------%----%-----------%%%%%%------%
%------%----%----------------%------%
%------%---------------------%------%
%------%---------------------%------%
%------%------%%%%%----------%------%
%------%------%%%%%-----------------%
%------%------%%%%%----------%%%%%%%%
%------%-------------%%%------%-----%
%--------------------%%%------%-----%
%----%---------------%%%------%-----%
%----%------%%%------%%%------%-----%
%%%%%%------%%%------%%%%%%%%%%-----%
%-----------%%%---------------------%
%%%%%%%%%%%%%%%%%%%%%%%%%%%%%%%%%%%%%
