%%%%%%%%%%%%%%%%%%%%%%%%%%%%%%%%%%%%%
%-----------------------------------%
%-----------------------------------%
%-----------------------------------%
%-----%%%%%%%%%%%%%%%%----%-%-%-----%
%-----%%%%%%%%%%%%%%%%-----%%%------%
%-----%%%%%%%%%%%%%%%%-----%%%------%
%-----%%%%--------%%%%----%-%-%-----%
%-----%%%%--------%%%%--------------%
%-----%%%%--------%%%%--------------%
%-----%%%%%%%--%%%%%%%--------------%
%-----%%%%%%%--%%%%%%%--------------%
%-----%%%%--------%%%%--------------%
%-----%%%%--------%%%%--------------%
%-----%%%%--------%%%%--------------%
%-----%%%%--------%%%%--------------%
%-----%%%%--------%%%%--------------%
%-----------------------------------%
%-----------------------------------%
%%%%%%%%%%%%%%%%%%%%%%%%%%%%%%%%%%%%%
