%%%%%%%%%%%%%%%%%%%%%%%%%%%%%%%%%%%%%
%-------------%------------%--------%
%----%%%%%----%------------%--------%
%----%--------%---------------------%
%----%--------%%%%%%%%%-------------%
%----%---------------------%--------%
%----%---------------------%--------%
%----%%%%%%%%%%%%%%--------%%%%%%%%%%
%---------------------------%-------%
%---------------------------%-------%
%----%%%%%----%---------------------%
%----%--------%---------------------%
%----%--------%%%%%%%%%-----%-------%
%----%----------------------%-------%
%----%----------------------%-------%
%%%%%%%%%%%%%%%%%%%%%%%%%%%%%%%%%%%%%
