%%%%%%%%%%%%%%%%%%%%%%%%%%%%%%%%%%%%%
%-----%-----------------------------%
%-----%-----------------------------%
%-----%-----%-----------------------%
%-----%-----%-----------------------%
%-----%-----%-----------------------%
%-----------%-----------------------%
%-----------%-----------------------%
%%%%%%%%%%%%%%%%%%%%%%%%%%%%%%%%%%%%%
