%%%%%%%%%%%%%%%%%%%%%%%%%%%%%%%%%%%%%
%-------%-%-%-----------%---%-----%-%
%-%%%%%%%-%-%%%-%-%%%-%%%-%%%%%%%-%-%
%-------%-------%-%-----%-----%-%---%
%%%%%-%%%%%-%%%-%-%-%-%%%-%%%%%-%-%%%
%---%-%-%-%---%-%-%-%---%-%---%-%---%
%-%%%-%-%-%-%%%-%%%%%-%%%-%-%%%-%%%-%
%-------%-----%---%---%-----%-%-%---%
%%%%%%%%%%%%%%%%%%%%%%%%%%%%%%%%%%%%%
